{
    "map": [
      "####################",
      "#..............#...#",
      "#.###.####.###.#.#.#",
      "#.###.####.###.#.#.#",
      "#..................#",
      "#.###.#.#######.###.",
      "#.#.#.#.#######.###.",
      "#.#.#.#............#",
      "#.#.#.#############.",
      "#.#...............#.",
      "#.#################.",
      "#..................#",
      "####################"
    ],
    "playerStartPosition": {
      "x": 1,
      "y": 1
    },
    "dotCount": 32
  }
  